#########  #########
#+................+#
#.#######  #######.#
#.#+............+#.#
#.#.############.#.#
#.#.#............#.#
#.#.#.###++###.#... 
#.#.#.###++###.#... 
#.#.#$........$#.#.#
#.#.############.#.#
#.#+............+#.#
#.#######..#######.#
#+................+#
#########  #########
