#########  #########
#+................+#
#.#######  #######.#
#.#+............+#.#
#.#.############.#.#
#.#.#.....b......#.#
#.#.#.###++###.#... 
#.#.#.###++###.#... 
#.#.#$....p...$#.#.#
#.#.############.#.#
#.#+............+#.#
#.#######..#######.#
#+........g.......+#
#########  #########
