####################
#..................#
#..................#
#..................#
#..................#
#..................#
#.................. 
#.................. 
#..................#
#..................#
#..................#
#..................#
#..................#
####################
