#########  #########
#$$$$$$$$$$$$$$$$$$#
#$$$$$$$$$$$$$$$$$$#
#$$$$$$$$$$$$$$$$$$#
#$$$$$$$$$$$$$$$$$$#
#$$$$$$$$$$$$$$$$$$#
#$$$$$$$$$$$$$$$$$$ 
#$$$$$$$$$$$$$$$$$$ 
#$$$$$$$$$$$$$$$$$$#
#$$$$$$$$$$$$$$$$$$#
#$$$$$$$$$$$$$$$$$$#
#$$$$$$$$.$$$$$$$$$#
#$$$$$$$$$$$$$$$$$$#
####################
