####################
#..................#
#.#######..........#
#....$.....#######.#
#.#######+....$....#
#....$.....#######.#
#.#######.....$....
#....$....+#######.
#.#######.....$....#
#....$.....#######.#
#.#######+....$....#
#..........#######.#
#..................#
#########  #########
