#########  #########
#$$$$$$$$$$$$$$$$$$#
#$$$$b$$$$$$$$$$$$$#
#$$$$$$$$$$$$$$$$$$#
#$$$$$$$$$$$$$$$$$$#
#$$$$$$$$$$$$$$$$$$#
#$$$$$$$$$$$$$$$$$$ 
#$$p$$$$$$$$$$$$$$$ 
#$$$$$$$$$$$$$$$$$$#
#$$$$$$$$$$$$$$$$$$#
#$$$$$$$$$$$$$$$$$$#
#$$$$$$$$g$$$$$$$$$#
#$$$$$$$$$$$$$$$$$$#
####################
