####################
#...#...#....#...#.#
#.#...#....#...#...#
#.################.#
#.#+............+#.#
#.#...########...#.#
 .....#..$...#.....#
 ........##........#
#.#...#...$..#...#.#
#.#...########...#.#
#.#+............+#.#
#.################.#
#..................#
#########  #########
