####################
#+................+#
#..................#
#........##........#
#........$$........#
#......#$$$$#......#
 .....#$$$$$$#..... 
 ....#$$$$$$$$#.... 
#...#$$$$$$$$$$#...#
#..#$$$$$$$$$$$$#..#
#.#$$$$$$$$$$$$$$#.#
#.################.#
#+.......gpb......+#
####################
