#########  #########
#$.................#
#.################.#
#.#.............##.#
#.#...#...#...#..#.#
#.#.#...#...#...##.#
 .#...#...#...#..#. 
 .#.#.+.#.+.#.+.##. 
#.#...#...#...#..#.#
#.#.#...#...#...##.#
#.#..............#.#
#.#######..#######.#
#.................$#
####################
