#########  #########
#$.................#
#.################.#
#.#......g......##.#
#.#...#...#...#..#.#
#.#.#...#...#...##.#
 .#...#...#...#..#. 
 .#.#.+.#.+.#.+.##. 
#.#...#...#...#..#.#
#.#.#...#...#...##.#
#.#......bp......#.#
#.#######..#######.#
#.................$#
####################
