####################
#..................#
#..................#
#..................#
#..................#
#..................#
 .................. 
 .................. 
#..................#
#..................#
#..................#
#..................#
#..................#
####################
