#########  #########
#..................#
#.#######..........#
#.#........#####...#
#.#..#.........#...#
#.#..#..######.#...#
#.#..#..#$...#.#...#
#.#..#..#.++.#.#...#
#.#..####.++.###...#
#.#.........$#.#...#
#.############.#...#
#..............#...#
#..................#
#########  #########
