####################
#..................#
#..................#
#..................#
#..................#
#..................#
 ..................#
 ..................#
#..................#
#..................#
#..................#
#..................#
#..................#
#########  #########
