#########  #########
#.......#..........#
#......#+..........#
#...b...#..........#
#........#.........#
#.........#........#
 ....$$...+#...$$..#
 ....$$...#....$$..#
#........#.........#
#.......#+.........#
#....g...#.........#
#.........#......p.#
#.........+#.......#
####################
