####################
#..................#
#.##.####..####.##.#
#.##.####$$####.##.#
#.##.##########.##.#
#.##............##.#
 .##.............+.#
 .##.+.............#
#.##.####..####.##.#
#.##.####..####.##.#
#.##.####..####.##.#
#.##............##.#
#..................#
#########  #########
