#########  #########
#..............p...#
#.#######..........#
#.#........#####...#
#.#..#...b.....#...#
#.#..#..######.#...#
#.#..#..#$...#.#...#
#.#..#..#.++.#.#...#
#.#..####.++.###...#
#.#......g..$#.#...#
#.############.#...#
#..............#...#
#..................#
#########  #########
